{
  "name": "bg",
  "description": "standard Bulgarian layout",
  "geometry": "ISO",
  "layout": {
    "AE01": [ "1", "!" ],
    "AE02": [ "2", "?" ],
    "AE03": [ "3", "+" ],
    "AE04": [ "4", "\"" ],
    "AE05": [ "5", "%" ],
    "AE06": [ "6", "=" ],
    "AE07": [ "7", ":" ],
    "AE08": [ "8", "/" ],
    "AE09": [ "9", "–" ],
    "AE10": [ "0", "№" ],
    "AD01": [ "ы", "Ы" ],
    "AD02": [ "у", "У" ],
    "AD03": [ "е", "Е" ],
    "AD04": [ "и", "И" ],
    "AD05": [ "ш", "Ш" ],
    "AD06": [ "щ", "Щ" ],
    "AD07": [ "к", "К" ],
    "AD08": [ "с", "С" ],
    "AD09": [ "д", "Д" ],
    "AD10": [ "з", "З" ],
    "AC01": [ "ѝ", "Ѝ" ],
    "AC02": [ "я", "Я" ],
    "AC03": [ "а", "А" ],
    "AC04": [ "о", "О" ],
    "AC05": [ "ж", "Ж" ],
    "AC06": [ "г", "Г" ],
    "AC07": [ "т", "Т" ],
    "AC08": [ "н", "Н" ],
    "AC09": [ "в", "В" ],
    "AC10": [ "м", "М" ],
    "AB01": [ "ю", "Ю" ],
    "AB02": [ "й", "Й" ],
    "AB03": [ "ъ", "Ъ" ],
    "AB04": [ "э", "Э" ],
    "AB05": [ "ф", "Ф" ],
    "AB06": [ "х", "Х" ],
    "AB07": [ "п", "П" ],
    "AB08": [ "р", "Р" ],
    "AB09": [ "л", "Л" ],
    "AB10": [ "б", "Б" ],
    "AE11": [ "-", "$" ],
    "AE12": [ ".", "€" ],
    "AD11": [ "ц", "Ц" ],
    "AD12": [ ";", "§" ],
    "AC11": [ "ч", "Ч" ],
    "TLDE": [ "(", ")" ],
    "BKSL": [ "„", "“" ],
    "LSGT": [ "/", "|" ],
    "SPCE": [ " ", " " ]
  },
  "dead_keys": [],
  "has_altgr": false
}
