{
  "name": "qwerty-uk",
  "description": "British QWERTY layout",
  "geometry": "ISO",
  "layout": {
    "AE01": [ "1", "!" ],
    "AE02": [ "2", "\"" ],
    "AE03": [ "3", "£" ],
    "AE04": [ "4", "$", "€" ],
    "AE05": [ "5", "%" ],
    "AE06": [ "6", "^" ],
    "AE07": [ "7", "&" ],
    "AE08": [ "8", "*" ],
    "AE09": [ "9", "(" ],
    "AE10": [ "0", ")" ],
    "AD01": [ "q", "Q" ],
    "AD02": [ "w", "W" ],
    "AD03": [ "e", "E", "é", "É" ],
    "AD04": [ "r", "R" ],
    "AD05": [ "t", "T" ],
    "AD06": [ "y", "Y" ],
    "AD07": [ "u", "U", "ú", "Ú" ],
    "AD08": [ "i", "I", "í", "Í" ],
    "AD09": [ "o", "O", "ó", "Ó" ],
    "AD10": [ "p", "P" ],
    "AC01": [ "a", "A", "á", "Á" ],
    "AC02": [ "s", "S" ],
    "AC03": [ "d", "D" ],
    "AC04": [ "f", "F" ],
    "AC05": [ "g", "G" ],
    "AC06": [ "h", "H" ],
    "AC07": [ "j", "J" ],
    "AC08": [ "k", "K" ],
    "AC09": [ "l", "L" ],
    "AC10": [ ";", ":" ],
    "AB01": [ "z", "Z" ],
    "AB02": [ "x", "X" ],
    "AB03": [ "c", "C" ],
    "AB04": [ "v", "V" ],
    "AB05": [ "b", "B" ],
    "AB06": [ "n", "N" ],
    "AB07": [ "m", "M" ],
    "AB08": [ ",", "<" ],
    "AB09": [ ".", ">" ],
    "AB10": [ "/", "?" ],
    "AE11": [ "-", "_" ],
    "AE12": [ "=", "+" ],
    "AD11": [ "[", "{" ],
    "AD12": [ "]", "}" ],
    "AC11": [ "'", "@" ],
    "TLDE": [ "`", "¬", "¦" ],
    "BKSL": [ "#", "~" ],
    "LSGT": [ "\\", "|" ],
    "SPCE": [ " ", " ", " ", " " ]
  },
  "dead_keys": [],
  "has_altgr": true
}
