{
  "name": "йцукен-ru-legacy",
  "description": "Russian JCUKEN layout, legacy variant",
  "geometry": "ALT",
  "layout": {
    "AE01": [ "1", "!" ],
    "AE02": [ "2", "\"" ],
    "AE03": [ "3", "#" ],
    "AE04": [ "4", "*" ],
    "AE05": [ "5", ":" ],
    "AE06": [ "6", "," ],
    "AE07": [ "7", "." ],
    "AE08": [ "8", ";" ],
    "AE09": [ "9", "(" ],
    "AE10": [ "0", ")" ],
    "AD01": [ "й", "Й" ],
    "AD02": [ "ц", "Ц" ],
    "AD03": [ "у", "У" ],
    "AD04": [ "к", "К" ],
    "AD05": [ "е", "Е" ],
    "AD06": [ "н", "Н" ],
    "AD07": [ "г", "Г" ],
    "AD08": [ "ш", "Ш" ],
    "AD09": [ "щ", "Щ" ],
    "AD10": [ "з", "З" ],
    "AC01": [ "ф", "Ф" ],
    "AC02": [ "ы", "Ы" ],
    "AC03": [ "в", "В" ],
    "AC04": [ "а", "А" ],
    "AC05": [ "п", "П" ],
    "AC06": [ "р", "Р" ],
    "AC07": [ "о", "О" ],
    "AC08": [ "л", "Л" ],
    "AC09": [ "д", "Д" ],
    "AC10": [ "ж", "Ж" ],
    "AB01": [ "я", "Я" ],
    "AB02": [ "ч", "Ч" ],
    "AB03": [ "с", "С" ],
    "AB04": [ "м", "М" ],
    "AB05": [ "и", "И" ],
    "AB06": [ "т", "Т" ],
    "AB07": [ "ь", "Ь" ],
    "AB08": [ "б", "Б" ],
    "AB09": [ "ю", "Ю" ],
    "AB10": [ "/", "?" ],
    "AE11": [ "-", "_" ],
    "AE12": [ "=", "+" ],
    "AD11": [ "х", "Х" ],
    "AD12": [ "ъ", "Ъ" ],
    "AC11": [ "э", "Э" ],
    "TLDE": [ "ё", "Ё" ],
    "BKSL": [ "\\", "|" ],
    "SPCE": [ " ", " " ]
  },
  "dead_keys": [],
  "has_altgr": false
}
