{
  "name": "colemak-us",
  "description": "American Colemak layout",
  "geometry": "ANSI",
  "layout": {
    "AE01": [ "1", "!" ],
    "AE02": [ "2", "@" ],
    "AE03": [ "3", "#" ],
    "AE04": [ "4", "$" ],
    "AE05": [ "5", "%" ],
    "AE06": [ "6", "^" ],
    "AE07": [ "7", "&" ],
    "AE08": [ "8", "*" ],
    "AE09": [ "9", "(" ],
    "AE10": [ "0", ")" ],
    "AD01": [ "q", "Q" ],
    "AD02": [ "w", "W" ],
    "AD03": [ "f", "F" ],
    "AD04": [ "p", "P" ],
    "AD05": [ "g", "G" ],
    "AD06": [ "j", "J" ],
    "AD07": [ "l", "L" ],
    "AD08": [ "u", "U" ],
    "AD09": [ "y", "Y" ],
    "AD10": [ ";", ":" ],
    "AC01": [ "a", "A" ],
    "AC02": [ "r", "R" ],
    "AC03": [ "s", "S" ],
    "AC04": [ "t", "T" ],
    "AC05": [ "d", "D" ],
    "AC06": [ "h", "H" ],
    "AC07": [ "n", "N" ],
    "AC08": [ "e", "E" ],
    "AC09": [ "i", "I" ],
    "AC10": [ "o", "O" ],
    "AB01": [ "z", "Z" ],
    "AB02": [ "x", "X" ],
    "AB03": [ "c", "C" ],
    "AB04": [ "v", "V" ],
    "AB05": [ "b", "B" ],
    "AB06": [ "k", "K" ],
    "AB07": [ "m", "M" ],
    "AB08": [ ",", "<" ],
    "AB09": [ ".", ">" ],
    "AB10": [ "/", "?" ],
    "AE11": [ "-", "_" ],
    "AE12": [ "=", "+" ],
    "AD11": [ "[", "{" ],
    "AD12": [ "]", "}" ],
    "AC11": [ "'", "\"" ],
    "TLDE": [ "`", "~" ],
    "BKSL": [ "\\", "|" ],
    "SPCE": [ " ", " " ]
  },
  "dead_keys": [],
  "has_altgr": false
}
