{
  "layout": {
    "AE01": [ "1", "!" ],
    "AE02": [ "2", "@" ],
    "AE03": [ "3", "#" ],
    "AE04": [ "4", "$" ],
    "AE05": [ "5", "%" ],
    "AE06": [ "6", "^" ],
    "AE07": [ "7", "&" ],
    "AE08": [ "8", "*" ],
    "AE09": [ "9", "(" ],
    "AE10": [ "0", ")" ],
    "AD01": [ "'", "\"" ],
    "AD02": [ ",", "<" ],
    "AD03": [ ".", ">" ],
    "AD04": [ "p", "P" ],
    "AD05": [ "y", "Y" ],
    "AD06": [ "f", "F" ],
    "AD07": [ "g", "G" ],
    "AD08": [ "c", "C" ],
    "AD09": [ "r", "R" ],
    "AD10": [ "l", "L" ],
    "AC01": [ "a", "A" ],
    "AC02": [ "o", "O" ],
    "AC03": [ "e", "E" ],
    "AC04": [ "u", "U" ],
    "AC05": [ "i", "I" ],
    "AC06": [ "d", "D" ],
    "AC07": [ "h", "H" ],
    "AC08": [ "t", "T" ],
    "AC09": [ "n", "N" ],
    "AC10": [ "s", "S" ],
    "AB01": [ ";", ":" ],
    "AB02": [ "q", "Q" ],
    "AB03": [ "j", "J" ],
    "AB04": [ "k", "K" ],
    "AB05": [ "x", "X" ],
    "AB06": [ "b", "B" ],
    "AB07": [ "m", "M" ],
    "AB08": [ "w", "W" ],
    "AB09": [ "v", "V" ],
    "AB10": [ "z", "Z" ],
    "AE11": [ "[", "{" ],
    "AE12": [ "]", "}" ],
    "AD11": [ "/", "?" ],
    "AD12": [ "=", "+" ],
    "AC11": [ "-", "_" ],
    "TLDE": [ "`", "~" ],
    "BKSL": [ "\\", "|" ],
    "LSGT": [ "\\", "|" ],
    "SPCE": [ " ", " " ]
  },
  "dead_keys": [],
  "has_altgr": false
}
