{
  "layout": {
    "AE01": [ "1", "!" ],
    "AE02": [ "2", "@" ],
    "AE03": [ "3", "#" ],
    "AE04": [ "4", "$" ],
    "AE05": [ "5", "%" ],
    "AE06": [ "6", "^" ],
    "AE07": [ "7", "&" ],
    "AE08": [ "8", "*" ],
    "AE09": [ "9", "(" ],
    "AE10": [ "0", ")" ],
    "AD01": [ "q", "Q" ],
    "AD02": [ "d", "D" ],
    "AD03": [ "r", "R" ],
    "AD04": [ "w", "W" ],
    "AD05": [ "b", "B" ],
    "AD06": [ "j", "J" ],
    "AD07": [ "f", "F" ],
    "AD08": [ "u", "U" ],
    "AD09": [ "p", "P" ],
    "AD10": [ ";", ":" ],
    "AC01": [ "a", "A" ],
    "AC02": [ "s", "S" ],
    "AC03": [ "h", "H" ],
    "AC04": [ "t", "T" ],
    "AC05": [ "g", "G" ],
    "AC06": [ "y", "Y" ],
    "AC07": [ "n", "N" ],
    "AC08": [ "e", "E" ],
    "AC09": [ "o", "O" ],
    "AC10": [ "i", "I" ],
    "AB01": [ "z", "Z" ],
    "AB02": [ "x", "X" ],
    "AB03": [ "m", "M" ],
    "AB04": [ "c", "C" ],
    "AB05": [ "v", "V" ],
    "AB06": [ "k", "K" ],
    "AB07": [ "l", "L" ],
    "AB08": [ ",", "<" ],
    "AB09": [ ".", ">" ],
    "AB10": [ "/", "?" ],
    "AE11": [ "-", "_" ],
    "AE12": [ "=", "+" ],
    "AD11": [ "[", "{" ],
    "AD12": [ "]", "}" ],
    "AC11": [ "'", "\"" ],
    "TLDE": [ "`", "~" ],
    "BKSL": [ "\\", "|" ],
    "LSGT": [ "\\", "|" ],
    "SPCE": [ " ", " " ]
  },
  "dead_keys": [],
  "has_altgr": false
}
